s..........
...........
#..........
.#.........
..#........
...#.......
....#......
....f#.....
......#....
...#####...
...........
